{
  "id": "test",
  "name": "Test Map",
  "width": 20,
  "height": 12,
  "grid": [
    [0, 0, 0, 0, 0, 0, 0, 0, 0, 0, 0, 0, 0, 0, 0, 0, 0, 0, 0, 0],
    [0, 0, 1, 1, 1, 0, 0, 2, 2, 2, 2, 0, 0, 3, 3, 3, 0, 0, 0, 0],
    [0, 1, 1, 1, 1, 1, 0, 2, 2, 2, 2, 2, 0, 3, 3, 3, 3, 0, 0, 0],
    [0, 1, 1, 1, 1, 0, 0, 0, 2, 2, 2, 0, 0, 3, 3, 3, 3, 3, 0, 0],
    [0, 0, 1, 1, 4, 4, 4, 0, 0, 5, 5, 5, 0, 0, 3, 3, 0, 0, 0, 0],
    [0, 0, 0, 4, 4, 4, 4, 4, 0, 5, 5, 5, 5, 0, 0, 0, 0, 0, 0, 0],
    [0, 0, 4, 4, 4, 4, 4, 0, 0, 5, 5, 5, 5, 5, 0, 6, 6, 6, 0, 0],
    [0, 0, 4, 4, 0, 0, 0, 0, 0, 0, 5, 5, 0, 0, 0, 6, 6, 6, 6, 0],
    [0, 0, 0, 0, 0, 7, 7, 7, 0, 0, 0, 0, 0, 8, 8, 6, 6, 6, 0, 0],
    [0, 0, 0, 0, 7, 7, 7, 7, 7, 0, 0, 8, 8, 8, 8, 8, 0, 0, 0, 0],
    [0, 0, 0, 0, 7, 7, 7, 7, 0, 0, 0, 8, 8, 8, 8, 0, 0, 0, 0, 0],
    [0, 0, 0, 0, 0, 0, 0, 0, 0, 0, 0, 0, 0, 0, 0, 0, 0, 0, 0, 0]
  ],
  "territories": {
    "1": { "name": "Northwest", "resource": "timber" },
    "2": { "name": "North Central", "resource": "coal" },
    "3": { "name": "Northeast", "resource": "iron" },
    "4": { "name": "West", "resource": "gold" },
    "5": { "name": "Central", "resource": "horses" },
    "6": { "name": "East", "resource": "timber" },
    "7": { "name": "Southwest", "resource": "iron" },
    "8": { "name": "Southeast", "resource": "coal" }
  }
}

